111111111111111
1P0000000000001
101011111110101
101000100010001
111110101011101
100010101000001
101010101011111
101000100010001
101111101110101
100000000000001
101111111011101
101000001000001
101011101011101
100000000000001
111111111111111
